0 1 1 1 1 1 1 1 1 1 1 1 1 1 1 1 1 1 1 1 1 1 1 1 1 1 1 1 1 1 1 1 1 1 1 1 1 1 1 2
11 12 12 12 12 12 12 12 12 12 57 12 69 12 12 12 71 68 12 55 12 12 12 12 12 12 12 12 12 12 12 12 12 12 55 12 60 12 12 13
11 68 12 12 12 12 70 12 12 12 12 12 12 12 12 70 12 71 12 12 12 12 12 12 12 12 12 56 58 12 12 12 12 12 12 12 12 12 60 13
11 12 12 12 12 57 12 12 12 60 12 12 12 12 12 12 12 12 68 12 12 12 12 12 56 12 12 12 12 12 12 12 12 12 58 12 69 56 12 13
11 12 12 12 12 12 12 12 57 12 12 12 12 12 12 69 70 12 56 12 12 12 12 71 12 12 12 12 12 12 70 12 12 12 12 58 12 12 12 13
11 12 12 12 12 12 12 57 12 12 12 12 12 12 12 12 12 70 55 55 12 12 12 12 12 12 12 71 12 12 71 66 12 12 12 12 12 12 12 13
11 66 12 12 55 12 12 12 58 60 12 12 12 12 68 12 12 12 12 12 12 12 12 12 12 12 12 69 12 69 12 12 12 12 12 12 12 12 12 13
11 12 12 58 12 12 12 12 12 12 12 12 12 57 12 60 12 69 12 69 12 12 68 12 12 12 12 12 12 12 12 12 12 12 12 12 12 12 60 13
11 12 12 12 12 12 12 57 12 12 66 56 12 12 12 12 12 12 12 12 12 12 12 12 12 12 68 12 68 12 12 71 12 66 12 12 12 12 12 13
11 12 12 55 12 12 12 12 12 71 12 12 12 12 12 12 12 12 68 12 12 12 12 12 12 12 56 12 12 12 12 12 12 12 12 66 55 58 12 13
11 12 12 12 12 12 12 12 57 12 12 12 12 12 58 12 12 66 12 12 12 12 12 71 56 12 12 57 12 12 12 12 12 66 12 12 12 12 12 13
11 12 12 12 12 12 12 12 57 59 12 12 12 12 12 55 58 12 12 12 12 71 12 12 12 12 12 12 12 12 12 12 12 57 12 12 12 12 67 13
11 12 12 12 12 12 12 66 12 12 12 12 70 12 12 12 70 12 12 12 12 58 66 12 12 12 12 12 55 12 12 12 12 12 12 12 70 12 12 13
11 12 12 71 12 12 12 12 60 12 12 12 70 12 12 12 12 12 12 12 56 12 12 12 12 12 12 12 71 12 12 12 70 12 12 12 70 12 12 13
11 12 12 12 12 12 12 59 12 12 57 12 12 57 12 12 12 12 12 12 59 12 12 66 12 12 12 12 59 12 12 12 55 12 12 12 12 12 12 13
11 12 12 60 12 12 12 67 12 12 12 12 12 12 12 12 12 67 12 12 57 12 12 58 66 12 12 12 12 12 12 12 12 12 12 12 58 12 12 13
11 68 12 12 12 55 12 69 12 57 12 12 12 12 67 12 12 56 12 12 12 12 12 66 12 12 12 12 12 12 12 12 12 12 12 12 12 12 12 13
11 58 12 12 12 60 56 59 12 56 12 12 12 12 12 12 55 12 12 12 12 12 59 12 12 12 12 12 12 12 12 12 12 12 12 12 12 12 12 13
11 71 12 12 12 12 12 12 12 12 67 12 69 70 12 12 12 12 68 12 12 12 12 12 12 12 12 70 12 12 68 12 12 12 12 12 12 12 12 13
11 12 12 69 12 12 12 12 12 12 12 12 12 67 12 12 59 12 12 12 12 12 60 56 12 58 12 12 12 12 12 12 68 12 12 12 12 12 12 13
11 12 12 12 12 12 55 12 71 12 12 12 12 58 12 12 12 12 12 12 12 12 12 12 57 12 12 12 12 12 12 12 12 12 69 12 57 70 12 13
11 12 66 12 12 12 12 12 68 12 12 12 60 12 12 12 12 70 12 12 12 55 12 57 12 12 12 12 12 12 12 12 12 12 12 60 12 12 12 13
11 12 12 12 66 12 70 12 12 60 12 12 12 12 12 12 12 12 12 67 12 12 12 70 12 12 68 12 12 12 12 12 12 12 55 12 12 12 12 13
11 12 12 12 12 12 12 12 58 12 12 67 12 69 12 12 12 12 12 12 12 70 12 12 71 12 12 12 69 12 12 12 12 12 12 12 12 12 60 13
11 12 12 12 12 59 12 69 12 70 12 12 58 12 12 12 12 12 12 12 58 12 12 68 12 12 12 12 12 12 12 71 12 12 12 12 12 12 12 13
11 12 12 12 12 12 12 12 12 12 12 12 12 12 12 12 12 12 12 58 12 12 56 12 12 12 12 58 71 12 56 12 12 12 12 12 12 71 71 13
11 71 12 12 70 71 12 67 12 12 12 12 12 56 12 12 12 12 12 12 12 12 12 12 12 12 12 12 12 12 59 12 12 12 12 12 12 12 71 13
11 12 12 58 67 12 12 12 12 12 12 12 12 12 12 12 12 12 12 12 12 12 12 12 56 12 66 12 12 12 12 12 67 60 12 70 12 12 12 13
11 12 12 12 12 12 12 12 60 12 12 12 71 12 12 12 12 12 12 12 12 12 12 68 12 12 71 12 69 58 12 12 12 70 12 12 12 12 12 13
11 12 12 12 71 12 12 12 12 68 12 12 55 12 12 12 12 66 12 12 12 59 12 12 12 12 12 12 12 66 12 12 12 12 12 69 12 12 12 13
11 12 12 12 12 12 58 12 12 59 12 12 12 12 12 12 12 56 12 68 12 12 12 12 60 12 12 12 12 12 12 12 12 69 55 12 12 12 12 13
11 12 12 12 12 12 12 12 12 68 70 12 67 12 59 12 12 12 12 12 12 58 56 12 59 12 12 12 12 12 12 12 12 12 12 12 12 12 12 13
11 12 12 12 12 60 12 12 12 12 12 60 12 66 12 12 68 12 60 59 12 12 12 69 12 12 12 12 12 12 12 12 12 12 12 12 12 12 12 13
11 12 12 12 56 12 12 12 12 68 12 12 12 12 12 12 12 12 70 12 12 55 12 12 12 12 12 12 69 12 57 12 12 12 12 12 12 66 12 13
11 12 12 12 12 59 12 12 66 69 12 70 12 12 66 12 12 66 12 12 12 59 12 12 12 12 12 12 12 12 12 12 12 12 12 12 12 12 12 13
11 12 60 12 12 12 12 12 12 12 12 66 12 12 12 12 12 12 12 58 12 12 12 12 12 12 12 12 12 66 12 12 12 70 12 69 69 12 12 13
11 12 12 12 55 69 12 12 58 12 12 59 12 12 12 12 12 12 12 12 12 12 12 12 12 67 12 12 12 12 12 12 12 68 12 12 12 58 12 13
11 12 55 12 12 12 12 12 12 12 12 12 12 12 59 67 12 69 12 12 12 12 12 69 12 12 12 12 12 12 12 12 12 12 12 12 67 12 68 13
11 12 12 12 12 12 12 12 12 12 12 12 12 12 66 12 71 12 12 12 56 12 12 12 56 12 12 12 12 12 57 12 12 57 12 12 70 12 12 13
22 23 23 23 23 23 23 23 23 23 23 23 23 23 23 23 23 23 23 23 23 23 23 23 23 23 23 23 23 23 23 23 23 23 23 23 23 23 23 24
